S111111111111
L71F-71000001
1I1I1L-710101
1L-J111I10101
1011100I11111
1010001L---71
10101100111I1
11111111111G1